XPXXXXXXXXXXXXXXXXXXXXXXXX
X*****XX****X******* XXXXX
XXX  ****XX***XXXXX*  XXXX
XXX   XXXX**XXXXXX **XXXXX
XXX   XXXXXXXXXXXXXX*   XX
X     XXXXXX    XX  *XXXXX
XXX             XXXX*****X
XXXXXXXXXXXXXXXXXXXXXXXX*X