XXXXXXXXXXXXXXXXXXXXXXXXXXXXXXXXXXXXXXXX
X              XX                      X
X  XXX         XX                      X
X                   XXX                X
X        X                     XXXXXXXXX
X        X                XXXXXXXXXXXXXX
X P      X       XXX             XXXXXXX
X        X                             X
X       XX                             X
XXXXXXXXXXXXXXXXXXXXXXXXXXXXXXXXXXXXXXXX