XXXXXXXXXX
X        X
X        X
X P  X   X
X    X   X
X    X   X
X        X
X        X
XXXXXXXXXX