XXXXXXXXXXXXX
X       X   X
X       X   X
X     P     X
XXXX        X
X        XXXX
X        X  X
XXXXXXXXXXXXX